document	label
3단계	__label__옵션
밀떡변경	__label__옵션
분모자변경	__label__옵션
파마산	__label__옵션
콩가루	__label__옵션
계란1개	__label__옵션
비엔나5개	__label__옵션
가래떡1개	__label__옵션
어묵사리	__label__옵션
치즈사리	__label__옵션
분모자	__label__옵션
테스트상품1	__label__drop
오픈행사(남포동과순살치킨)	__label__순살 치킨
닭갈비가래떡볶이	__label__떡볶이
카스(병)	__label__카스
테라(병)	__label__테라
카프리(병)	__label__카프리
소주(처음처럼)	__label__처음처럼
소주(참이슬 순한)	__label__참이슬 fresh
소주(진로이즈백)	__label__진로
(포장할인)남순모SET	__label__?
(포장할인) 남포동과순살치킨	__label__순살 치킨
(포장할인)할가떡튀김SET	__label__떡볶이 튀김 세트
(포장할인)어떡할가SET	__label__?
(포장할인)남김모SET	__label__?
특선세트10P(1인분)	__label__초밥
초밥세트12P(1인분)	__label__초밥
초밥세트26P(2인분)	__label__초밥
연어세트12P(1인분)	__label__초밥
스시앤롤세트22P(2인분)	__label__초밥
호온세트	__label__초밥
간장새우초밥4p	__label__초밥
구운소고기초밥4p	__label__초밥
생연어초밥4p	__label__초밥
구운연어초밥4p	__label__초밥
광어초밥4p	__label__초밥
구운장어초밥4p	__label__초밥
초새우초밥4p	__label__초밥
구운계란초밥4p	__label__초밥
구운유부초밥4p	__label__초밥
구운새우초밥4p	__label__초밥
관자초밥 4p	__label__초밥
한치 4p	__label__초밥
구운게살 4p	__label__초밥
한치 4p	__label__초밥
구운게살 4p	__label__초밥
캘리포니아롤9p	__label__롤
연어아보카도롤9p	__label__롤
치킨카츠아보카도롤9p	__label__롤
연어스테이크롤8p	__label__롤
구운장어롤 8p	__label__롤
연어크림치즈아보카도롤9p	__label__롤
콤비네이션롤9p	__label__롤
한개우동	__label__우동
반개우동	__label__우동
모듬고로케3p	__label__고로케
새우튀김 3p	__label__튀김
타코야끼볼 6p	__label__타코야끼
등심돈까스+유부초밥	__label__돈까스+초밥
치즈돈까스+유부초밥	__label__돈까스+초밥
냉모밀	__label__냉모밀
펩시콜라	__label__콜라
칠성사이다	__label__사이다
미린다파인	__label__미린다
밀키스	__label__밀키스
마운틴듀 	__label__마운틴듀
대선 	__label__대선
참이슬 	__label__참이슬
좋은데이	__label__좋은데이
진로	__label__진로
테라 	__label__테라
카스 	__label__카스
클라우드	__label__클라우드
처음처럼	__label__처음처럼
스파클링	__label__스파클링
트로피카나스파클링 오랜지	__label__스파클링
연어	__label__옵션
광어	__label__옵션
장어	__label__옵션
관자	__label__옵션
소고기	__label__옵션
초새우	__label__옵션
간장새우	__label__옵션
한치	__label__옵션
대게살	__label__옵션
계란	__label__옵션
유부	__label__옵션
진맛살(롤용)	__label__옵션
새우튀김	__label__옵션
감자고로케	__label__옵션
카레고로케	__label__옵션
야채고로케	__label__옵션
타코야끼볼	__label__옵션
락교	__label__옵션
생와사비	__label__옵션
산고추	__label__옵션
초생강(적)	__label__옵션
단무지	__label__옵션
날치알	__label__옵션
돈카츠	__label__옵션
치즈카츠	__label__옵션
치킨카츠	__label__옵션
우동면	__label__옵션
우동쯔유	__label__옵션
우동어묵	__label__옵션
가쓰오부시	__label__옵션
돈카츠소스	__label__옵션
타르타르소스	__label__옵션
파슬리	__label__옵션
초대리	__label__옵션
데리야끼소스	__label__옵션
스파이시소스	__label__옵션
김	__label__옵션
붕어간장	__label__옵션
스시4용기	__label__drop
스시10용기	__label__drop
스시12용기	__label__drop
스시26용기	__label__drop
돈까스용기	__label__drop
롤용기	__label__drop
우동용기	__label__drop
우동국물(소)	__label__drop
우동국물(대)	__label__drop
반찬용기	__label__drop
비닐봉지(소)	__label__drop
비닐봉지(대)	__label__drop
나무젓가락	__label__drop
해동지	__label__drop
카페라떼	__label__카페라떼
바닐라라떼	__label__바닐라라떼
헤이즐넛아메리카노	__label__헤이즐넛아메리카노
연유라떼	__label__연유라떼
카라멜 마끼아또	__label__카라멜마끼아또
카페모카	__label__카페모카
민트모카	__label__민트모카
꿀 아메리카노	__label__꿀 아메리카노
꿀 카페라떼	__label__꿀 카페라떼
치즈크림 아메리카노(only ice)	__label__치즈크림 아메리카노
치즈크림 카페라떼(only ice)	__label__치즈크림 카페라떼
시럽/샷/휘핑/코코넛젤리추가	__label__옵션
아메리카노	__label__아메리카노
1리터아메(only ice)	__label__아메리카노
(행사)아메리카노	__label__아메리카노
카푸치노	__label__카푸치노
초코라떼	__label__초코라떼
녹차라떼	__label__녹차라떼
밀크티	__label__밀크티
고구마라떼	__label__고구마라떼
흑임자라떼	__label__흑임자라떼
딸기라떼(only ice)	__label__딸기라떼
민트초코라떼	__label__민트초코라떼
이천쌀라떼(only hot)	__label__이천쌀라떼
초코버블라떼(only ice)	__label__초코버블라떼
그린티버블라떼(only ice)	__label__그린티버블라떼
쿠앤크버블라떼(only ice)	__label__쿠앤크버블라떼
딸기버블라떼(only ice)	__label__딸기버블라떼
흑당버블라떼(only ice)	__label__흑당버블라떼
오곡라떼	__label__오곡라떼
커피 프라페	__label__커피 프라페
헤이즐넛  프라페	__label__헤이즐넛 프라페
녹차 프라페	__label__녹차 프라페
민트초코칩 프라페	__label__민트초코칩 프라페
자바칩 프라페	__label__자바칩 프라페
쿠앤크 프라페	__label__쿠앤크 프라페
이천쌀 프라페	__label__이천쌀 프라페
플레인 요거트 스무디	__label__플레인 요거트 스무디
딸기 요거트 스무디	__label__딸기 요거트 스무디
망고 요거트 스무디	__label__망고 요거트 스무디
자두 요거트 스무디	__label__자두 요거트 스무디
큐브수박스무디(계절)	__label__큐브 수박 스무디
큐브망고스무디(계절)	__label__큐브 망고 스무디
인절미 빙수치노	__label__인절미 빙수치노
딸기 빙수치노	__label__딸기 빙수치노
흑임자 빙수치노	__label__흑임자 빙수치노
바닐라 코코팝	__label__바닐라 코코팝
딸기 코코팝	__label__딸기 코코팝
쿠앤크 코코팝	__label__쿠앤크 코코팝
밀크 쉐이크	__label__밀크 쉐이크
딸기오레오 쉐이크	__label__딸기오레오 쉐이크
오레오 쉐이크	__label__오레오 쉐이크
녹차오레오 쉐이크	__label__녹차오레오 쉐이크
꿀고구마아메세트	__label__고구마+아메리카노
꿀고구마라떼세트	__label__고구마+카페라떼
꿀고구마단짝아메세트	__label__?
딸기주스	__label__딸기 주스
바나나주스	__label__바나나 주스
딸기바나나주스	__label__딸기 바나나 주스
키위주스	__label__키위 주스
토마토주스	__label__토마토 주스
오렌지주스	__label__오렌지 주스
블루베리주스	__label__블루베리 주스
망고주스	__label__망고 주스
핑크레몬 에이드	__label__핑크 레몬 에이드
블루레몬 에이드	__label__블루 레몬 에이드
청포도 에이드	__label__청포도 에이드
자몽에이드	__label__자몽 에이드
자두에이드	__label__자두 에이드
복숭아 아이스티	__label__복숭아 아이스티
홍차_얼그레이	__label__얼그레이
허브티_캐모마일	__label__캐모마일
허브티_레몬그라스	__label__레몬그라스
꿀 캐미유자차	__label__유자차
꿀 레몬그라스차	__label__꿀 레몬그라스차
꿀 블랙오미자차	__label__꿀 블랙오미자차
1리터 아이스티  (only ice)	__label__아이스티
쿠키 2종	__label__쿠키
베이글칩 2종 (허니버터 갈릭버터)	__label__베이글칩
웨하스 2종 (나폴리타너바닐라)	__label__웨하스
스투룹와플	__label__스투룹 와플
앤디스초콜릿 2종	__label__초콜릿
초코칩 머핀	__label__초코 머핀
비스킷슈 2종(바닐라초코)	__label__비스킷 슈
크림카스테라	__label__카스테라
말렌카케이크 2종(월넛코코아)	__label__캐이크
모카번	__label__모카번
머핀 2종(초코블루베리)	__label__머핀
마카롱 5종	__label__마카롱
크림치즈 프레즐	__label__프레즐
베이글+크림치즈	__label__베이글
소시지 페스츄리	__label__페스츄리
크로크무슈	__label__크로크무슈
미니 떡볶이	__label__떡볶이
치즈미니 떡볶이	__label__치즈 떡볶이
꿀고구마	__label__고구마
꿀고구마3개	__label__고구마
허니버터 꿀고구마	__label__고구마
허니치즈 꿀고구마	__label__고구마
콘마요 꿀고구마	__label__고구마
생크림와플	__label__와플
사과잼와플	__label__와플
딸기잼와플	__label__와플
블루베리잼와플	__label__와플
달달고구마와플	__label__와플
팥이동동 와플	__label__와플
누텔라콕콕와플	__label__와플
블루베리크림치즈와플	__label__와플
피넛딸기와플	__label__와플
피넛블루베리와플	__label__와플
콘체다와플	__label__와플
시나몬바게트볼	__label__시나몬 바케트 볼
스콘 2종 (건포도호두)	__label__스콘
잉글리쉬머핀	__label__머핀
브라우니	__label__브라우니
아이스크림 브라우니	__label__브라우니
플레인크로플	__label__크로플
시나몬크로플	__label__크로플
인절미크로플	__label__크로플
누텔라크로플	__label__크로플
체다치즈크로플	__label__크로플
크림치즈크로플	__label__크로플
애플시나몬크로플	__label__크로플
딸기크로플	__label__크로플
블루베리크로플	__label__크로플
초코크런치크로플	__label__크로플
티라미수크로플	__label__크로플
콘체다크로플	__label__크로플
젤라소프트	__label__아이스크림
아포가토(Only Iced)	__label__아포카토
플레인 소프트	__label__아이스크림
콘소프트 	__label__아이스크림
망고소프트 	__label__아이스크림
초코쿠키소프트	__label__아이스크림
아포가토소프트	__label__아이스크림
Hot	__label__옵션
Ice	__label__옵션
선택 없음	__label__옵션
바닐라시럽 추가	__label__옵션
샷 추가	__label__옵션
휘핑 추가	__label__옵션
코코넛 젤리 추가	__label__옵션
라떼로 변경 1잔	__label__옵션
로키로드 쿠키	__label__쿠키
오트밀레이즌 쿠키	__label__쿠키
초콜릿 청크 쿠키	__label__쿠키
허니버터 베이글칩	__label__베이글칩
갈릭버터 베이글칩	__label__베이글칩
나폴리타너 웨하스	__label__웨하스
바닐라 웨하스	__label__웨하스
민트파르페 앤디스초콜릿	__label__초콜릿
크림데민트 앤디스초콜릿	__label__초콜릿
바닐라 비스킷슈	__label__비스킷 슈
초코 비스킷슈	__label__비스킷슈
월넛 말렌카케이크	__label__케이크
코코아 말렌카케이크	__label__케이크
초코 머핀	__label__머핀
블루베리 머핀	__label__머핀
말차초코 마카롱	__label__마카롱
핑크딸기 마카롱	__label__마카롱
황치즈 마카롱	__label__마카롱
얼그레이 마카롱	__label__마카롱
초코라떼 마카롱	__label__마카롱
플레인 베이글	__label__베이글
어니언 베이글	__label__베이글
블루베리 베이글	__label__베이글
건포도 스콘	__label__스콘
호두 스콘	__label__스콘
바닐라 젤라소프트	__label__아이스크림
바닐라&초코 젤라소프트	__label__아이스크림
망고 젤라소프트	__label__아이스크림
